10
10
##########
#........#
#h..Bb...#
#........#
####g#####
#f.......#
#...bb...#
#........#
#...f....#
##########
