12
10
##########
#h.......#
#...b..b.#
#........#
#...#.#..#
#........#
#........#
#........#
#........#
#........#
#...f.f..#
##########
