8
8
########
#h.....#
#...b..#
#......#
#......#
#...f..#
#......#
########
