10
10
##########
#hB..#...#
#...p#.b.#
#....#...#
#....#..p#
#....#####
#........#
#..#g#.b.#
#..#f#...#
##########
