10
10
##########
#h...#...#
#..bb#p..#
#....#...#
##########
#f..#....#
#...#...p#
#...#....#
#..f#....#
##########
