10
10
##########
#h.......#
#...b....#
#........#
#...#..#.#
#........#
#...B.g..#
#........#
#...f....#
##########
