7
8
#########
#h.....#
#...b..#
#......#
#......#
#...f..#
########
