10
10
##########
#h...#.B.#
#.bp.#.p.#
#....#.b.#
#######g##
#####....#
#####....#
#####....#
#####f...#
##########
