7
8
#########
#h.....#
#......#
#......#
#......#
#......#
########
