10
10
##########
#h.......#
#...b....#
#........#
#........#
#........#
#........#
#........#
#...f....#
##########

