10
10
##########
#h.......#
#...b.p..#
#........#
##########
#........#
#...p....#
#........#
#...f....#
##########

